xxxxxxxxxx
..........
......i...
.....i....
..........
..i.e.....
....e.....
..........
..........
xxxxxxxxxx